19 11
0 0 1 1 1 1 1 1 1 1 1 1 1 1 1 1 1 1 1
0 0 1 0 0 0 0 0 0 0 1 0 0 0 0 0 0 0 2
0 0 1 0 0 4 5 0 0 0 1 0 5 4 0 0 0 0 2
0 0 1 0 1 1 1 1 1 0 1 1 1 1 0 0 1 1 1
0 0 1 0 1 0 0 0 0 0 1 0 0 0 0 0 1 1 1
0 0 1 0 1 0 0 5 4 0 1 0 5 0 0 0 1 1 1
1 1 1 0 1 0 1 1 1 1 1 1 1 1 0 0 1 1 1
0 0 0 0 1 0 0 0 0 0 0 0 0 0 0 0 1 1 1
0 6 0 0 1 0 0 4 4 4 0 0 0 0 5 0 1 1 1
1 1 1 1 1 1 1 1 1 1 1 1 1 1 1 1 1 1 1
1 1 1 1 1 1 1 1 1 1 1 1 1 1 1 1 1 1 1